11111111111111111111111111111111111111111111111111111111111111111111111111111
22222222222222222222222222222222222222222222222222222222222222222222222222222
00000000000000000000000000000000000000000000000000000000000000000000000000000
00000000000000000000000000000000000000000000000000000000000000000000000000000
00000000000000000000000000000000000000000000000000000000000000000000000000000
00000000000000000000000000000000000000000000000000000002220000000000000000000
00000000000000000000000000000000000000000000000002220000000000000000000000000
00000000000000000000000000000000000000000222000000000000000000222000000000000
00000000000002220000000000000000000000000000002220000000222000000000000000000
00000000002221112220000000000000000000022200000000000000000000000002220000000
00000002221111111112220000000000022200000000000000000000002220000000000000000
00002221111111111111112220000000000000000000000000000000000000000000000000000
11111111111111111111111111111111111111111111111111111111111111111111111111111
22222222222222222222222222222222222222222222222222222222222222222222222222222