00000000000000000000000000000000000000000000000000000000000000000000000000000
00000000000000000000000000000000000000000000000000000000000000000000000000000
00000000000000220000000000000000000000000000000000000220000000000000000000000
00000000000000110000000000000000000000000000000000000110000000000000000000000
00000000000000000000000000000000000000000000000220000000000000000000000000000
00220000000000000000000000220000000000220000000110000000000000000000000000000
00110000000000000000000000110000000000110000000000000000000022000000000000000
00000000000000000000000000000000000000000000000000000000000011000000000000000
00000000000002200000000000000000000000000000000000000000000000000000000000000
00000000000001100000000000000000000000000000000000000000000000000000000000000
00000000000000000000000000000000000000000000000000000000000000000000000000000
22222222222200000000000000000000000000000000000000000000000000222222222222222
11111111111100000000000000000000000000000000000000000000000000111111111111111