11111111111111111111111111111111111111111111111111111111
12222222222222222222222222222222222222222222222222222222
12000000000000000000000000000000000000000000000000000021
12000000000000000000000000000000000000222200000000000021
12000000000000000000000000000000000000000000022220000021
12000000000000000000000000000000000000000000000000000021
00000000000000000000000000000000000000000000000000022221
00000000000000000000000000000000000000000000000000000021
00000000000000000000000000000000000000000000000222200021
00000000000000000000000000000000000000002222000000000021
22222222222222222222222222222222222222222222222222222221
11111111111111111111111111111111111111111111111111111111
