111111111111111111111111111111111111111111111111111111111111111111111111111111
222222222222222222222222222222222222222222222222222222222222222222222222222222
000000000000000000000000000000000000000000000000000000000000000000000000000000
000000000000000000000000000000000000000000000000000000000000000000000000000000
000000000000000000000000000000000000000000000000000000000000000000000000000000
000000000000000000000000000000000000000010000000000001111111111111111111111111
000000000000000000000000100000000000000020000000000002222222222222222222222222
000000000000001000001000200000000010000000000001000000000000000000000000000000
000000000010002000002000000001000020000000000002000000000000000000000000000000
000000010020000000000000000002000000000000000000000011000000000000000111111111
000000020000000000000000000000000000000000000000000022000000000000000222222222
222222222222222222222222222222222222222222222222222222222222222222222222222222
111111111111111111111111111111111111111111111111111111111111111111111111111111