00000000000000000000000000000000000000000000000000000000000000000000000000000000
00000000000000000000000000000000000000000000000000000000000000000000000000000000
00000000000000000000000000000000000000000000000000000000000000000000000002222222
22222222220000022222222222200002222222222222000022222222222222222222222222222222
00000000000000000000000000000000000000000000000000000000000000000000000000000002
00000000000000000000000000000000000000000000000000000000000000000000000000000002
00000222222222222222222222200002222222222222222222222222222222222222222000022222
00000000000000000000000000000000000000000000000000000000000000000000000000000002
00000000000000000000000000000000000000000000000000000000000000000000000000000002
22222222222222222222222222200002222222222222222222000022222222222222000000000002
00000000000000000000000000000000000000000000000000000000000000000000000000022222
00000000000000000000000000000000000000000000000000000000000000000000000000022222
11111111111111111111111111111111111111111111111111111111111111111111111111111112
22222222222222222222222222222222222222222222222222222222222222222222222222222222