111111111111111111111111111111111111111111111111111111111111111
222222222222222222222222222222222222222222222222222222222222221
120000000000000000000000000000000000000000000000000000000000021
120000000000000000000000000000000000000000000000000000000000021
122222222000000020000002000000200000020000002220000000000000021
120000000000000000000000000000000000000000000000000002222222221
120000000000000000000000000000000000000000000000020001111111121
122222222222200000000000000000000000000000000200000000000000021
000000000000000000000000000000200000002000000000000000000000021
000000000000000000002222220000000000000000000000000000000000021
000000000000000000001111110000000000000000000000000000000000021
222222222222222222222222222222222222222222222222222222222222221
111111111111111111111111111111111111111111111111111111111111111